1111111111
1P001111111111
100011111111
100011111
100CE1111111111111111111111111111
111111
