11111111111111111111111111111
1010C00C101C00000000E0011CC01
10000000000CC1100000CC0011101
10000000000000000P11110000CC1
11111111111111111111111111111