1111111111111111111111111111111111111111111111111111111111111111111111111111111111111111111111111111111111
1000000000000000000000000000000CC00000000000000P00000000000000000CC000000000000000000000000000000000000001
10000010000000000000000000E0000000000C0C0001000C00000C00000000000000000000000000000000CC0000000000000000C1
1111111111111111111111111111111111111111111111111111111111111111111111111111111111111111111111111111111111