111111
10P111
10E011
1001C1
111111