111111
10P111
11C011
1E10C1
111111