1111111111
110000P001
1C000E0001
1111111111